1 13 31
###############################
#p      * *    *   *  * * *   #
# ##  #*# # #*#*# # # #*#*#*# #
#  x*  b  ***  *      *   * * #
# # # # # #*# # #*#*# # # # #*#
#f         x  1  *  *         #
# # # # # # # # # #*# #*# # # #
#*  *      *  *2     *        #
# # # # #*# # # #*#*# # # # # #
#*    **  *       *           #
# #*# # # # # # #*# # # # # # #
#           *   *  *          #
###############################