1 13 31
###############################
#p      * *    *   *  * * *   #
# ##  #*# # #*#*# # # #*#*#*# #
#   *  b       *      *   * * #
# # # # # #*# # #*#*# # # # #*#
#f           **  *  *         #
# # # # # # # # # #*# #*# # # #
#*  *      *  *      *        #
# # # # #*# # # #*#*# # # # # #
#*    **  *       *           #
# #*# # # # # # #*# # # # # # #
#           *   *  *        5x#
###############################