1 13 31
###############################
#p      * *    *   *  * * *   #
# ##  #*# # #*#*# # # #*#*#*# #
#   *  b       *      *   * * #
# # # # # #*# # #*#*# # # # #*#
#f           **  *  *         #
# # # # # # # # # #*# #*# # # #
#*  *      *  *      *3       #
# # # # #*# # # #*#*# # # # # #
#*    **  *       * 4         #
# #*# # # # # # #*# # # # # # #
#           *   *  *         x#
###############################